/<var>	wagtail.core.views.serve	wagtail_serve
/_util/authenticate_with_password/<int:page_view_restriction_id>/<int:page_id>/	wagtail.core.views.authenticate_with_password	wagtailcore_authenticate_with_password
/_util/login/	django.contrib.auth.views.LoginView	wagtailcore_login
/admin/	wagtail.admin.views.home.default
/admin/	wagtail.admin.views.home.home	wagtailadmin_home
/admin/Projects/project/	wagtail.contrib.modeladmin.options.index_view	Projects_project_modeladmin_index
/admin/Projects/project/create/	wagtail.contrib.modeladmin.options.create_view	Projects_project_modeladmin_create
/admin/Projects/project/delete/<instance_pk>/	wagtail.contrib.modeladmin.options.delete_view	Projects_project_modeladmin_delete
/admin/Projects/project/edit/<instance_pk>/	wagtail.contrib.modeladmin.options.edit_view	Projects_project_modeladmin_edit
/admin/Projects/projectcategory/	wagtail.contrib.modeladmin.options.index_view	Projects_projectcategory_modeladmin_index
/admin/Projects/projectcategory/create/	wagtail.contrib.modeladmin.options.create_view	Projects_projectcategory_modeladmin_create
/admin/Projects/projectcategory/delete/<instance_pk>/	wagtail.contrib.modeladmin.options.delete_view	Projects_projectcategory_modeladmin_delete
/admin/Projects/projectcategory/edit/<instance_pk>/	wagtail.contrib.modeladmin.options.edit_view	Projects_projectcategory_modeladmin_edit
/admin/account/	wagtail.admin.views.account.account	wagtailadmin_account
/admin/account/change_avatar/	wagtail.admin.views.account.change_avatar	wagtailadmin_account_change_avatar
/admin/account/change_email/	wagtail.admin.views.account.change_email	wagtailadmin_account_change_email
/admin/account/change_name/	wagtail.admin.views.account.change_name	wagtailadmin_account_change_name
/admin/account/change_password/	wagtail.admin.views.account.change_password	wagtailadmin_account_change_password
/admin/account/current_time_zone/	wagtail.admin.views.account.current_time_zone	wagtailadmin_account_current_time_zone
/admin/account/language_preferences/	wagtail.admin.views.account.language_preferences	wagtailadmin_account_language_preferences
/admin/account/notification_preferences/	wagtail.admin.views.account.notification_preferences	wagtailadmin_account_notification_preferences
/admin/api/main/documents/	wagtail.documents.api.admin.views.DocumentsAdminAPIViewSet	wagtailadmin_api:documents:listing
/admin/api/main/documents/<int:pk>/	wagtail.documents.api.admin.views.DocumentsAdminAPIViewSet	wagtailadmin_api:documents:detail
/admin/api/main/documents/find/	wagtail.documents.api.admin.views.DocumentsAdminAPIViewSet	wagtailadmin_api:documents:find
/admin/api/main/images/	wagtail.images.api.admin.views.ImagesAdminAPIViewSet	wagtailadmin_api:images:listing
/admin/api/main/images/<int:pk>/	wagtail.images.api.admin.views.ImagesAdminAPIViewSet	wagtailadmin_api:images:detail
/admin/api/main/images/find/	wagtail.images.api.admin.views.ImagesAdminAPIViewSet	wagtailadmin_api:images:find
/admin/api/main/pages/	wagtail.admin.api.views.PagesAdminAPIViewSet	wagtailadmin_api:pages:listing
/admin/api/main/pages/<int:pk>/	wagtail.admin.api.views.PagesAdminAPIViewSet	wagtailadmin_api:pages:detail
/admin/api/main/pages/find/	wagtail.admin.api.views.PagesAdminAPIViewSet	wagtailadmin_api:pages:find
/admin/choose-anchor-link/	wagtail.admin.views.chooser.anchor_link	wagtailadmin_choose_page_anchor_link
/admin/choose-email-link/	wagtail.admin.views.chooser.email_link	wagtailadmin_choose_page_email_link
/admin/choose-external-link/	wagtail.admin.views.chooser.external_link	wagtailadmin_choose_page_external_link
/admin/choose-page/	wagtail.admin.views.chooser.browse	wagtailadmin_choose_page
/admin/choose-page/<int:parent_page_id>/	wagtail.admin.views.chooser.browse	wagtailadmin_choose_page_child
/admin/choose-page/search/	wagtail.admin.views.chooser.search	wagtailadmin_choose_page_search
/admin/choose-phone-link/	wagtail.admin.views.chooser.phone_link	wagtailadmin_choose_page_phone_link
/admin/collections/	wagtail.admin.views.collections.Index	wagtailadmin_collections:index
/admin/collections/<int:collection_id>/privacy/	wagtail.admin.views.collection_privacy.set_privacy	wagtailadmin_collections:set_privacy
/admin/collections/<int:pk>/	wagtail.admin.views.collections.Edit	wagtailadmin_collections:edit
/admin/collections/<int:pk>/delete/	wagtail.admin.views.collections.Delete	wagtailadmin_collections:delete
/admin/collections/add/	wagtail.admin.views.collections.Create	wagtailadmin_collections:add
/admin/documents/	wagtail.documents.views.documents.index	wagtaildocs:index
/admin/documents/add/	wagtail.documents.views.documents.add	wagtaildocs:add
/admin/documents/chooser/	wagtail.documents.views.chooser.chooser	wagtaildocs:chooser
/admin/documents/chooser/<int:document_id>/	wagtail.documents.views.chooser.document_chosen	wagtaildocs:document_chosen
/admin/documents/chooser/upload/	wagtail.documents.views.chooser.chooser_upload	wagtaildocs:chooser_upload
/admin/documents/delete/<int:document_id>/	wagtail.documents.views.documents.delete	wagtaildocs:delete
/admin/documents/edit/<int:document_id>/	wagtail.documents.views.documents.edit	wagtaildocs:edit
/admin/documents/multiple/<int:doc_id>/	wagtail.documents.views.multiple.edit	wagtaildocs:edit_multiple
/admin/documents/multiple/<int:doc_id>/delete/	wagtail.documents.views.multiple.delete	wagtaildocs:delete_multiple
/admin/documents/multiple/add/	wagtail.documents.views.multiple.add	wagtaildocs:add_multiple
/admin/documents/usage/<int:document_id>/	wagtail.documents.views.documents.usage	wagtaildocs:document_usage
/admin/embeds/chooser/	wagtail.embeds.views.chooser.chooser	wagtailembeds:chooser
/admin/embeds/chooser/upload/	wagtail.embeds.views.chooser.chooser_upload	wagtailembeds:chooser_upload
/admin/failwhale/	wagtail.admin.views.home.error_test	wagtailadmin_error_test
/admin/forms/	wagtail.contrib.forms.views.FormPagesListView	wagtailforms:index
/admin/forms/submissions/<int:page_id>/	wagtail.contrib.forms.views.get_submissions_list_view	wagtailforms:list_submissions
/admin/forms/submissions/<int:page_id>/delete/	wagtail.contrib.forms.views.DeleteSubmissionsView	wagtailforms:delete_submissions
/admin/groups/	wagtail.users.views.groups.IndexView	wagtailusers_groups:index
/admin/groups/<int:pk>/	wagtail.users.views.groups.EditView	wagtailusers_groups:edit
/admin/groups/<int:pk>/delete/	wagtail.users.views.groups.DeleteView	wagtailusers_groups:delete
/admin/groups/<var>/users/	wagtail.users.views.users.index	wagtailusers_groups:users
/admin/groups/new/	wagtail.users.views.groups.CreateView	wagtailusers_groups:add
/admin/images/	wagtail.images.views.images.index	wagtailimages:index
/admin/images/<int:image_id>/	wagtail.images.views.images.edit	wagtailimages:edit
/admin/images/<int:image_id>/delete/	wagtail.images.views.images.delete	wagtailimages:delete
/admin/images/<int:image_id>/generate_url/	wagtail.images.views.images.url_generator	wagtailimages:url_generator
/admin/images/<int:image_id>/generate_url/<str:filter_spec>/	wagtail.images.views.images.generate_url	wagtailimages:generate_url
/admin/images/<int:image_id>/preview/<str:filter_spec>/	wagtail.images.views.images.preview	wagtailimages:preview
/admin/images/add/	wagtail.images.views.images.add	wagtailimages:add
/admin/images/chooser/	wagtail.images.views.chooser.chooser	wagtailimages:chooser
/admin/images/chooser/<int:image_id>/	wagtail.images.views.chooser.image_chosen	wagtailimages:image_chosen
/admin/images/chooser/<int:image_id>/select_format/	wagtail.images.views.chooser.chooser_select_format	wagtailimages:chooser_select_format
/admin/images/chooser/upload/	wagtail.images.views.chooser.chooser_upload	wagtailimages:chooser_upload
/admin/images/multiple/<int:image_id>/	wagtail.images.views.multiple.edit	wagtailimages:edit_multiple
/admin/images/multiple/<int:image_id>/delete/	wagtail.images.views.multiple.delete	wagtailimages:delete_multiple
/admin/images/multiple/add/	wagtail.images.views.multiple.add	wagtailimages:add_multiple
/admin/images/multiple/create_from_uploaded_image/<int:uploaded_image_id>/	wagtail.images.views.multiple.create_from_uploaded_image	wagtailimages:create_multiple_from_uploaded_image
/admin/images/multiple/delete_upload/<int:uploaded_image_id>/	wagtail.images.views.multiple.delete_upload	wagtailimages:delete_upload_multiple
/admin/images/usage/<int:image_id>/	wagtail.images.views.images.usage	wagtailimages:image_usage
/admin/login/	wagtail.admin.views.account.LoginView	wagtailadmin_login
/admin/logout/	wagtail.admin.views.account.LogoutView	wagtailadmin_logout
/admin/pages/	wagtail.admin.views.pages.index	wagtailadmin_explore_root
/admin/pages/<int:page_id>/copy/	wagtail.admin.views.pages.copy	wagtailadmin_pages:copy
/admin/pages/<int:page_id>/delete/	wagtail.admin.views.pages.delete	wagtailadmin_pages:delete
/admin/pages/<int:page_id>/edit/	wagtail.admin.views.pages.edit	wagtailadmin_pages:edit
/admin/pages/<int:page_id>/edit/preview/	wagtail.admin.views.pages.PreviewOnEdit	wagtailadmin_pages:preview_on_edit
/admin/pages/<int:page_id>/history/	wagtail.admin.views.pages.PageHistoryView	wagtailadmin_pages:history
/admin/pages/<int:page_id>/lock/	wagtail.admin.views.pages.lock	wagtailadmin_pages:lock
/admin/pages/<int:page_id>/privacy/	wagtail.admin.views.page_privacy.set_privacy	wagtailadmin_pages:set_privacy
/admin/pages/<int:page_id>/revisions/	wagtail.admin.views.pages.revisions_index	wagtailadmin_pages:revisions_index
/admin/pages/<int:page_id>/revisions/<int:revision_id>/revert/	wagtail.admin.views.pages.revisions_revert	wagtailadmin_pages:revisions_revert
/admin/pages/<int:page_id>/revisions/<int:revision_id>/unschedule/	wagtail.admin.views.pages.revisions_unschedule	wagtailadmin_pages:revisions_unschedule
/admin/pages/<int:page_id>/revisions/<int:revision_id>/view/	wagtail.admin.views.pages.revisions_view	wagtailadmin_pages:revisions_view
/admin/pages/<int:page_id>/unlock/	wagtail.admin.views.pages.unlock	wagtailadmin_pages:unlock
/admin/pages/<int:page_id>/unpublish/	wagtail.admin.views.pages.unpublish	wagtailadmin_pages:unpublish
/admin/pages/<int:page_id>/view_draft/	wagtail.admin.views.pages.view_draft	wagtailadmin_pages:view_draft
/admin/pages/<int:page_id>/workflow_history/	wagtail.admin.views.pages.workflow_history	wagtailadmin_pages:workflow_history
/admin/pages/<int:page_id>/workflow_history/detail/<int:workflow_state_id>/	wagtail.admin.views.pages.workflow_history_detail	wagtailadmin_pages:workflow_history_detail
/admin/pages/<int:page_to_move_id>/move/	wagtail.admin.views.pages.move_choose_destination	wagtailadmin_pages:move
/admin/pages/<int:page_to_move_id>/move/<int:destination_id>/confirm/	wagtail.admin.views.pages.move_confirm	wagtailadmin_pages:move_confirm
/admin/pages/<int:page_to_move_id>/move/<int:viewed_page_id>/	wagtail.admin.views.pages.move_choose_destination	wagtailadmin_pages:move_choose_destination
/admin/pages/<int:page_to_move_id>/set_position/	wagtail.admin.views.pages.set_page_position	wagtailadmin_pages:set_page_position
/admin/pages/<int:parent_page_id>/	wagtail.admin.views.pages.index	wagtailadmin_explore
/admin/pages/<int:parent_page_id>/add_subpage/	wagtail.admin.views.pages.add_subpage	wagtailadmin_pages:add_subpage
/admin/pages/<var>/revisions/compare/admin/pages/(\d+)/revisions/compare/<var>\.\.\.admin/pages/(\d+)/revisions/compare/(live|earliest|\d+)\.\.\.<var>/	wagtail.admin.views.pages.revisions_compare	wagtailadmin_pages:revisions_compare
/admin/pages/add/<slug:content_type_app_name>/<slug:content_type_model_name>/<int:parent_page_id>/	wagtail.admin.views.pages.create	wagtailadmin_pages:add
/admin/pages/add/<slug:content_type_app_name>/<slug:content_type_model_name>/<int:parent_page_id>/preview/	wagtail.admin.views.pages.PreviewOnCreate	wagtailadmin_pages:preview_on_add
/admin/pages/moderation/<int:revision_id>/approve/	wagtail.admin.views.pages.approve_moderation	wagtailadmin_pages:approve_moderation
/admin/pages/moderation/<int:revision_id>/preview/	wagtail.admin.views.pages.preview_for_moderation	wagtailadmin_pages:preview_for_moderation
/admin/pages/moderation/<int:revision_id>/reject/	wagtail.admin.views.pages.reject_moderation	wagtailadmin_pages:reject_moderation
/admin/pages/search/	wagtail.admin.views.pages.search	wagtailadmin_pages:search
/admin/pages/usage/<slug:content_type_app_name>/<slug:content_type_model_name>/	wagtail.admin.views.pages.content_type_use	wagtailadmin_pages:type_use
/admin/pages/workflow/action/<int:page_id>/<slug:action_name>/<int:task_state_id>/	wagtail.admin.views.pages.WorkflowAction	wagtailadmin_pages:workflow_action
/admin/pages/workflow/collect_action_data/<int:page_id>/<slug:action_name>/<int:task_state_id>/	wagtail.admin.views.pages.CollectWorkflowActionData	wagtailadmin_pages:collect_workflow_action_data
/admin/pages/workflow/confirm_cancellation/<int:page_id>/	wagtail.admin.views.pages.confirm_workflow_cancellation	wagtailadmin_pages:confirm_workflow_cancellation
/admin/pages/workflow/preview/<int:page_id>/<int:task_id>/	wagtail.admin.views.pages.preview_revision_for_task	wagtailadmin_pages:workflow_preview
/admin/pages/workflow/status/<int:page_id>/	wagtail.admin.views.pages.workflow_status	wagtailadmin_pages:workflow_status
/admin/password_reset/	wagtail.admin.views.account.PasswordResetView	wagtailadmin_password_reset
/admin/password_reset/complete/	wagtail.admin.views.account.PasswordResetCompleteView	wagtailadmin_password_reset_complete
/admin/password_reset/confirm/<uidb64>/<token>/	wagtail.admin.views.account.PasswordResetConfirmView	wagtailadmin_password_reset_confirm
/admin/password_reset/done/	wagtail.admin.views.account.PasswordResetDoneView	wagtailadmin_password_reset_done
/admin/redirects/	wagtail.contrib.redirects.views.index	wagtailredirects:index
/admin/redirects/<int:redirect_id>/	wagtail.contrib.redirects.views.edit	wagtailredirects:edit
/admin/redirects/<int:redirect_id>/delete/	wagtail.contrib.redirects.views.delete	wagtailredirects:delete
/admin/redirects/add/	wagtail.contrib.redirects.views.add	wagtailredirects:add
/admin/redirects/import/	wagtail.contrib.redirects.views.start_import	wagtailredirects:start_import
/admin/redirects/import/process/	wagtail.contrib.redirects.views.process_import	wagtailredirects:process_import
/admin/reports/locked/	wagtail.admin.views.reports.LockedPagesView	wagtailadmin_reports:locked_pages
/admin/reports/site-history/	wagtail.admin.views.reports.LogEntriesView	wagtailadmin_reports:site_history
/admin/reports/workflow/	wagtail.admin.views.reports.WorkflowView	wagtailadmin_reports:workflow
/admin/reports/workflow_tasks/	wagtail.admin.views.reports.WorkflowTasksView	wagtailadmin_reports:workflow_tasks
/admin/search/queries/chooser/	wagtail.search.views.queries.chooser	wagtailsearch_admin:queries_chooser
/admin/search/queries/chooser/results/	wagtail.search.views.queries.chooserresults	wagtailsearch_admin:queries_chooserresults
/admin/sites/	wagtail.sites.views.IndexView	wagtailsites:index
/admin/sites/<int:pk>/	wagtail.sites.views.EditView	wagtailsites:edit
/admin/sites/<int:pk>/delete/	wagtail.sites.views.DeleteView	wagtailsites:delete
/admin/sites/new/	wagtail.sites.views.CreateView	wagtailsites:add
/admin/snippets/	wagtail.snippets.views.snippets.index	wagtailsnippets:index
/admin/snippets/<slug:app_label>/<slug:model_name>/	wagtail.snippets.views.snippets.list	wagtailsnippets:list
/admin/snippets/<slug:app_label>/<slug:model_name>/<str:pk>/	wagtail.snippets.views.snippets.edit	wagtailsnippets:edit
/admin/snippets/<slug:app_label>/<slug:model_name>/<str:pk>/delete/	wagtail.snippets.views.snippets.delete	wagtailsnippets:delete
/admin/snippets/<slug:app_label>/<slug:model_name>/<str:pk>/usage/	wagtail.snippets.views.snippets.usage	wagtailsnippets:usage
/admin/snippets/<slug:app_label>/<slug:model_name>/add/	wagtail.snippets.views.snippets.create	wagtailsnippets:add
/admin/snippets/<slug:app_label>/<slug:model_name>/multiple/delete/	wagtail.snippets.views.snippets.delete	wagtailsnippets:delete-multiple
/admin/snippets/choose/	wagtail.snippets.views.chooser.choose	wagtailsnippets:choose_generic
/admin/snippets/choose/<slug:app_label>/<slug:model_name>/	wagtail.snippets.views.chooser.choose	wagtailsnippets:choose
/admin/snippets/choose/<slug:app_label>/<slug:model_name>/<str:pk>/	wagtail.snippets.views.chooser.chosen	wagtailsnippets:chosen
/admin/tag-autocomplete/	wagtail.admin.views.tags.autocomplete	wagtailadmin_tag_autocomplete
/admin/tag-autocomplete/<slug:app_name>/<slug:model_name>/	wagtail.admin.views.tags.autocomplete	wagtailadmin_tag_model_autocomplete
/admin/test404/	django.views.generic.base.TemplateView
/admin/userbar/<int:page_id>/	wagtail.admin.views.userbar.for_frontend	wagtailadmin_userbar_frontend
/admin/userbar/moderation/<int:revision_id>/	wagtail.admin.views.userbar.for_moderation	wagtailadmin_userbar_moderation
/admin/users/	wagtail.users.views.users.index	wagtailusers_users:index
/admin/users/<str:user_id>/	wagtail.users.views.users.edit	wagtailusers_users:edit
/admin/users/<str:user_id>/delete/	wagtail.users.views.users.delete	wagtailusers_users:delete
/admin/users/add/	wagtail.users.views.users.create	wagtailusers_users:add
/admin/wagtail_svgmap/imagemap/	wagtail.contrib.modeladmin.options.index_view	wagtail_svgmap_imagemap_modeladmin_index
/admin/wagtail_svgmap/imagemap/create/	wagtail.contrib.modeladmin.options.create_view	wagtail_svgmap_imagemap_modeladmin_create
/admin/wagtail_svgmap/imagemap/delete/<instance_pk>/	wagtail.contrib.modeladmin.options.delete_view	wagtail_svgmap_imagemap_modeladmin_delete
/admin/wagtail_svgmap/imagemap/edit/<instance_pk>/	wagtail.contrib.modeladmin.options.edit_view	wagtail_svgmap_imagemap_modeladmin_edit
/admin/wagtail_svgmap/region/	wagtail.contrib.modeladmin.options.index_view	wagtail_svgmap_region_modeladmin_index
/admin/wagtail_svgmap/region/create/	wagtail.contrib.modeladmin.options.create_view	wagtail_svgmap_region_modeladmin_create
/admin/wagtail_svgmap/region/delete/<instance_pk>/	wagtail.contrib.modeladmin.options.delete_view	wagtail_svgmap_region_modeladmin_delete
/admin/wagtail_svgmap/region/edit/<instance_pk>/	wagtail.contrib.modeladmin.options.edit_view	wagtail_svgmap_region_modeladmin_edit
/admin/wagtailmenus/flatmenu/	wagtail.contrib.modeladmin.options.index_view	wagtailmenus_flatmenu_modeladmin_index
/admin/wagtailmenus/flatmenu/copy/<instance_pk>/	wagtailmenus.modeladmin.copy_view	wagtailmenus_flatmenu_modeladmin_copy
/admin/wagtailmenus/flatmenu/create/	wagtail.contrib.modeladmin.options.create_view	wagtailmenus_flatmenu_modeladmin_create
/admin/wagtailmenus/flatmenu/delete/<instance_pk>/	wagtail.contrib.modeladmin.options.delete_view	wagtailmenus_flatmenu_modeladmin_delete
/admin/wagtailmenus/flatmenu/edit/<instance_pk>/	wagtail.contrib.modeladmin.options.edit_view	wagtailmenus_flatmenu_modeladmin_edit
/admin/wagtailmenus/mainmenu/	wagtail.contrib.modeladmin.options.index_view	wagtailmenus_mainmenu_modeladmin_index
/admin/wagtailmenus/mainmenu/edit/<instance_pk>/	wagtail.contrib.modeladmin.options.edit_view	wagtailmenus_mainmenu_modeladmin_edit
/admin/workflows/add/	wagtail.admin.views.workflows.Create	wagtailadmin_workflows:add
/admin/workflows/disable/<int:pk>/	wagtail.admin.views.workflows.Disable	wagtailadmin_workflows:disable
/admin/workflows/edit/<int:pk>/	wagtail.admin.views.workflows.Edit	wagtailadmin_workflows:edit
/admin/workflows/enable/<int:pk>/	wagtail.admin.views.workflows.enable_workflow	wagtailadmin_workflows:enable
/admin/workflows/list/	wagtail.admin.views.workflows.Index	wagtailadmin_workflows:index
/admin/workflows/remove/<int:page_pk>/	wagtail.admin.views.workflows.remove_workflow	wagtailadmin_workflows:remove
/admin/workflows/remove/<int:page_pk>/<int:workflow_pk>/	wagtail.admin.views.workflows.remove_workflow	wagtailadmin_workflows:remove
/admin/workflows/task_chooser/	wagtail.admin.views.workflows.task_chooser	wagtailadmin_workflows:task_chooser
/admin/workflows/task_chooser/<int:task_id>/	wagtail.admin.views.workflows.task_chosen	wagtailadmin_workflows:task_chosen
/admin/workflows/tasks/add/<str:app_label>/<str:model_name>/	wagtail.admin.views.workflows.CreateTask	wagtailadmin_workflows:add_task
/admin/workflows/tasks/disable/<int:pk>/	wagtail.admin.views.workflows.DisableTask	wagtailadmin_workflows:disable_task
/admin/workflows/tasks/edit/<int:pk>/	wagtail.admin.views.workflows.EditTask	wagtailadmin_workflows:edit_task
/admin/workflows/tasks/enable/<int:pk>/	wagtail.admin.views.workflows.enable_task	wagtailadmin_workflows:enable_task
/admin/workflows/tasks/index/	wagtail.admin.views.workflows.TaskIndex	wagtailadmin_workflows:task_index
/admin/workflows/tasks/select_type/	wagtail.admin.views.workflows.select_task_type	wagtailadmin_workflows:select_task_type
/admin/workflows/usage/<int:pk>/	wagtail.admin.views.workflows.usage	wagtailadmin_workflows:usage
/api/v2/	rest_framework.routers.APIRootView	api-root
/api/v2/\.<format>/	rest_framework.routers.APIRootView	api-root
/api/v2/projects/	Projects.api.ProjectViewSet	project-list
/api/v2/projects/user/<user>/	Projects.api.ProjectViewSet	project-user-list
/api/v2/projects/user/<user>\.<format>/	Projects.api.ProjectViewSet	project-user-list
/api/v2/projects\.<format>/	Projects.api.ProjectViewSet	project-list
/django-admin/	django.contrib.admin.sites.index	admin:index
/django-admin/<app_label>/	django.contrib.admin.sites.app_index	admin:app_list
/django-admin/auth/group/	django.contrib.admin.options.changelist_view	admin:auth_group_changelist
/django-admin/auth/group/<path:object_id>/	django.views.generic.base.RedirectView
/django-admin/auth/group/<path:object_id>/change/	django.contrib.admin.options.change_view	admin:auth_group_change
/django-admin/auth/group/<path:object_id>/delete/	django.contrib.admin.options.delete_view	admin:auth_group_delete
/django-admin/auth/group/<path:object_id>/history/	django.contrib.admin.options.history_view	admin:auth_group_history
/django-admin/auth/group/add/	django.contrib.admin.options.add_view	admin:auth_group_add
/django-admin/auth/group/autocomplete/	django.contrib.admin.options.autocomplete_view	admin:auth_group_autocomplete
/django-admin/django_celery_beat/clockedschedule/	django.contrib.admin.options.changelist_view	admin:django_celery_beat_clockedschedule_changelist
/django-admin/django_celery_beat/clockedschedule/<path:object_id>/	django.views.generic.base.RedirectView
/django-admin/django_celery_beat/clockedschedule/<path:object_id>/change/	django.contrib.admin.options.change_view	admin:django_celery_beat_clockedschedule_change
/django-admin/django_celery_beat/clockedschedule/<path:object_id>/delete/	django.contrib.admin.options.delete_view	admin:django_celery_beat_clockedschedule_delete
/django-admin/django_celery_beat/clockedschedule/<path:object_id>/history/	django.contrib.admin.options.history_view	admin:django_celery_beat_clockedschedule_history
/django-admin/django_celery_beat/clockedschedule/add/	django.contrib.admin.options.add_view	admin:django_celery_beat_clockedschedule_add
/django-admin/django_celery_beat/clockedschedule/autocomplete/	django.contrib.admin.options.autocomplete_view	admin:django_celery_beat_clockedschedule_autocomplete
/django-admin/django_celery_beat/crontabschedule/	django.contrib.admin.options.changelist_view	admin:django_celery_beat_crontabschedule_changelist
/django-admin/django_celery_beat/crontabschedule/<path:object_id>/	django.views.generic.base.RedirectView
/django-admin/django_celery_beat/crontabschedule/<path:object_id>/change/	django.contrib.admin.options.change_view	admin:django_celery_beat_crontabschedule_change
/django-admin/django_celery_beat/crontabschedule/<path:object_id>/delete/	django.contrib.admin.options.delete_view	admin:django_celery_beat_crontabschedule_delete
/django-admin/django_celery_beat/crontabschedule/<path:object_id>/history/	django.contrib.admin.options.history_view	admin:django_celery_beat_crontabschedule_history
/django-admin/django_celery_beat/crontabschedule/add/	django.contrib.admin.options.add_view	admin:django_celery_beat_crontabschedule_add
/django-admin/django_celery_beat/crontabschedule/autocomplete/	django.contrib.admin.options.autocomplete_view	admin:django_celery_beat_crontabschedule_autocomplete
/django-admin/django_celery_beat/intervalschedule/	django.contrib.admin.options.changelist_view	admin:django_celery_beat_intervalschedule_changelist
/django-admin/django_celery_beat/intervalschedule/<path:object_id>/	django.views.generic.base.RedirectView
/django-admin/django_celery_beat/intervalschedule/<path:object_id>/change/	django.contrib.admin.options.change_view	admin:django_celery_beat_intervalschedule_change
/django-admin/django_celery_beat/intervalschedule/<path:object_id>/delete/	django.contrib.admin.options.delete_view	admin:django_celery_beat_intervalschedule_delete
/django-admin/django_celery_beat/intervalschedule/<path:object_id>/history/	django.contrib.admin.options.history_view	admin:django_celery_beat_intervalschedule_history
/django-admin/django_celery_beat/intervalschedule/add/	django.contrib.admin.options.add_view	admin:django_celery_beat_intervalschedule_add
/django-admin/django_celery_beat/intervalschedule/autocomplete/	django.contrib.admin.options.autocomplete_view	admin:django_celery_beat_intervalschedule_autocomplete
/django-admin/django_celery_beat/periodictask/	django_celery_beat.admin.changelist_view	admin:django_celery_beat_periodictask_changelist
/django-admin/django_celery_beat/periodictask/<path:object_id>/	django.views.generic.base.RedirectView
/django-admin/django_celery_beat/periodictask/<path:object_id>/change/	django.contrib.admin.options.change_view	admin:django_celery_beat_periodictask_change
/django-admin/django_celery_beat/periodictask/<path:object_id>/delete/	django.contrib.admin.options.delete_view	admin:django_celery_beat_periodictask_delete
/django-admin/django_celery_beat/periodictask/<path:object_id>/history/	django.contrib.admin.options.history_view	admin:django_celery_beat_periodictask_history
/django-admin/django_celery_beat/periodictask/add/	django.contrib.admin.options.add_view	admin:django_celery_beat_periodictask_add
/django-admin/django_celery_beat/periodictask/autocomplete/	django.contrib.admin.options.autocomplete_view	admin:django_celery_beat_periodictask_autocomplete
/django-admin/django_celery_beat/solarschedule/	django.contrib.admin.options.changelist_view	admin:django_celery_beat_solarschedule_changelist
/django-admin/django_celery_beat/solarschedule/<path:object_id>/	django.views.generic.base.RedirectView
/django-admin/django_celery_beat/solarschedule/<path:object_id>/change/	django.contrib.admin.options.change_view	admin:django_celery_beat_solarschedule_change
/django-admin/django_celery_beat/solarschedule/<path:object_id>/delete/	django.contrib.admin.options.delete_view	admin:django_celery_beat_solarschedule_delete
/django-admin/django_celery_beat/solarschedule/<path:object_id>/history/	django.contrib.admin.options.history_view	admin:django_celery_beat_solarschedule_history
/django-admin/django_celery_beat/solarschedule/add/	django.contrib.admin.options.add_view	admin:django_celery_beat_solarschedule_add
/django-admin/django_celery_beat/solarschedule/autocomplete/	django.contrib.admin.options.autocomplete_view	admin:django_celery_beat_solarschedule_autocomplete
/django-admin/jsi18n/	django.contrib.admin.sites.i18n_javascript	admin:jsi18n
/django-admin/login/	django.contrib.admin.sites.login	admin:login
/django-admin/logout/	django.contrib.admin.sites.logout	admin:logout
/django-admin/password_change/	django.contrib.admin.sites.password_change	admin:password_change
/django-admin/password_change/done/	django.contrib.admin.sites.password_change_done	admin:password_change_done
/django-admin/r/<int:content_type_id>/<path:object_id>/	django.contrib.contenttypes.views.shortcut	admin:view_on_site
/django-admin/taggit/tag/	django.contrib.admin.options.changelist_view	admin:taggit_tag_changelist
/django-admin/taggit/tag/<path:object_id>/	django.views.generic.base.RedirectView
/django-admin/taggit/tag/<path:object_id>/change/	django.contrib.admin.options.change_view	admin:taggit_tag_change
/django-admin/taggit/tag/<path:object_id>/delete/	django.contrib.admin.options.delete_view	admin:taggit_tag_delete
/django-admin/taggit/tag/<path:object_id>/history/	django.contrib.admin.options.history_view	admin:taggit_tag_history
/django-admin/taggit/tag/add/	django.contrib.admin.options.add_view	admin:taggit_tag_add
/django-admin/taggit/tag/autocomplete/	django.contrib.admin.options.autocomplete_view	admin:taggit_tag_autocomplete
/django-admin/wagtail_svgmap/imagemap/	django.contrib.admin.options.changelist_view	admin:wagtail_svgmap_imagemap_changelist
/django-admin/wagtail_svgmap/imagemap/<path:object_id>/	django.views.generic.base.RedirectView
/django-admin/wagtail_svgmap/imagemap/<path:object_id>/change/	django.contrib.admin.options.change_view	admin:wagtail_svgmap_imagemap_change
/django-admin/wagtail_svgmap/imagemap/<path:object_id>/delete/	django.contrib.admin.options.delete_view	admin:wagtail_svgmap_imagemap_delete
/django-admin/wagtail_svgmap/imagemap/<path:object_id>/history/	django.contrib.admin.options.history_view	admin:wagtail_svgmap_imagemap_history
/django-admin/wagtail_svgmap/imagemap/add/	django.contrib.admin.options.add_view	admin:wagtail_svgmap_imagemap_add
/django-admin/wagtail_svgmap/imagemap/autocomplete/	django.contrib.admin.options.autocomplete_view	admin:wagtail_svgmap_imagemap_autocomplete
/django-admin/wagtaildocs/document/	django.contrib.admin.options.changelist_view	admin:wagtaildocs_document_changelist
/django-admin/wagtaildocs/document/<path:object_id>/	django.views.generic.base.RedirectView
/django-admin/wagtaildocs/document/<path:object_id>/change/	django.contrib.admin.options.change_view	admin:wagtaildocs_document_change
/django-admin/wagtaildocs/document/<path:object_id>/delete/	django.contrib.admin.options.delete_view	admin:wagtaildocs_document_delete
/django-admin/wagtaildocs/document/<path:object_id>/history/	django.contrib.admin.options.history_view	admin:wagtaildocs_document_history
/django-admin/wagtaildocs/document/add/	django.contrib.admin.options.add_view	admin:wagtaildocs_document_add
/django-admin/wagtaildocs/document/autocomplete/	django.contrib.admin.options.autocomplete_view	admin:wagtaildocs_document_autocomplete
/django-admin/wagtailimages/image/	django.contrib.admin.options.changelist_view	admin:wagtailimages_image_changelist
/django-admin/wagtailimages/image/<path:object_id>/	django.views.generic.base.RedirectView
/django-admin/wagtailimages/image/<path:object_id>/change/	django.contrib.admin.options.change_view	admin:wagtailimages_image_change
/django-admin/wagtailimages/image/<path:object_id>/delete/	django.contrib.admin.options.delete_view	admin:wagtailimages_image_delete
/django-admin/wagtailimages/image/<path:object_id>/history/	django.contrib.admin.options.history_view	admin:wagtailimages_image_history
/django-admin/wagtailimages/image/add/	django.contrib.admin.options.add_view	admin:wagtailimages_image_add
/django-admin/wagtailimages/image/autocomplete/	django.contrib.admin.options.autocomplete_view	admin:wagtailimages_image_autocomplete
/documents/<var>/documents/(\d+)/<var>	wagtail.documents.views.serve.serve	wagtaildocs_serve
/documents/authenticate_with_password/<int:restriction_id>/	wagtail.documents.views.serve.authenticate_with_password	wagtaildocs_authenticate_with_password
/media/<path>	django.views.static.serve
/search/	search.views.search	search
/static/<path>	django.contrib.staticfiles.views.serve
